AME.EnablePresetDB	false	false
AME.EncoderHost.NoXMP	false	false
AME.UseExportProgressCallback	true	true
AddDebugClipInfoToTimelineTooltips	false	false
AddTimestampToLogFileNames	false	false
AddUTCTimestampToTraces	false	false
AdobeCleanFontSize	12	12
AllowDynamicLinkToOwnProjectType	false	false
AllowMergedClipsToBeOpenedAsSequences	false	false
ApplicationLanguage	en_US	en_US
ApplicationLanguageBilingual	false	false
AudioAsioEnabled	true	true
AudioClockOffsetThreshold	0.20000000000000001	0.20000000000000001
AudioClockSkewCompensation	false	false
AudioClockSkewOffsetThreshold	0.10000000000000001	0.10000000000000001
AudioClockSkewSmoothingConstant	0.01	0.01
AudioDropoutDiskReadFallback	false	false
AudioFadeOutOnStop	true	true
AudioForceNoDevices	false	false
AudioIOPreventSuspending	false	false
AudioIgnoreSetIOSettings	false	false
AudioMaxShuttleSpeed	4	4
AudioOutputOnlyUI	false	false
AudioPrefetchDefaultTime	2	2
AudioPrefetchDelayDisk	0	0
AudioPrefetchOverloadThreshold	110	110
AudioProcessingBypassingEnabled	true	true
BE.CompressProjects	true	true
BE.DisableCS7RelinkUpdate	false	false
BE.ProjectLockFileRepeatedReadCount	0	0
Bravo.defaultLanguage	false	false
CTPreDefinedEncodingType	13	13
CloseAlwaysTimeoutInSeconds	300	300
CloseIfContentionTimeoutInSeconds	15	15
CodeProfiler_AutoStart	false	false
CodeProfiler_InitialVolume	5	5
Color.AutoSelectionFollowsPlayhead	true	true
CompareMediaNodeRenderers	false	false
CrashKeysEnabled	false	false
CreateLogFilesThatDoNotExist	false	false
DLG.DebugRelinkAsync	true	true
DLG.HideShortcutVisualizer	false	false
DS.Disable10BitSupport	false	false
DS.DisablePixelFormatShaders	false	false
DS.ForceCPUOnly	false	false
DS.ForceEnableVsync	false	false
DS.GPUSnifferOverride	0	0
DS.GPUSnifferTimeout	11000	11000
DS.disable_GL_ARB_cl_event	false	false
DSEnableDirectX	false	false
DVA.Dunamis.LogEvents	false	false
DVA.HWEncoding.AlwaysEnableHWEncoding	false	false
DVA.UI.SimulateHWEnc	false	false
DVA.UI.SimulateHWEnc.HWEnabled	true	true
DVA.graphicfindinterval	50000	50000
DVAGE697QuasiHackEnabled	true	true
DVA_syncWindowEnablement	false	false
DisableGPUMediaNode	false	false
DisableHighQualityAVCHDPlayback	false	false
DisableMainConceptDolby	false	false
DisableNewMediaNodeRenderer	false	false
DisableSequenceSettingMasterChannelType	true	true
DisableSpeculativePrefetching	false	false
DistanceFromLastStateToNeedANewMPEGInfo	20	20
DumpProject	false	false
DvaMarshalRPCLogging	false	false
EA.Config.LocalHub.InProcess	false	false
EA.Feature.CreateProductionTemplates	false	false
ESP.AssignAudioTypesToMultiselection	false	false
Effects.EnableExperimental	false	false
EnableDogEars	false	false
EnableGPUDebayer	true	true
EnableMaskMultiSelect	false	false
EnableMatchSourceForAll	false	false
EnableRadarLogging	false	false
Enable_Theme_Colorizing	false	false
ErrorReport.LogPlayback	false	false
EssentialSound.Restoration.UseERA	false	false
Export.UseRenditions	false	false
ExporterMPEG4.Feature.AllowNVidiaHWExport	false	false
ExporterMPEG4.Feature.AllowWinHEVCHWExport	true	true
ExporterMXF_CanSmartRenderJ2K_PQ	true	true
ExporterP2_SecondsPerPartition	10	10
ExporterQT.AnimationNativeEncoderEnabled	true	true
ExporterQT.DNxHDNativeSupportEnabled	true	true
FE.AllowMultipleOpenProjects	true	true
FE.AudioPluginScanOnFirstLaunch	true	true
FE.EnableReadOnlyProjects	true	true
FE.PerformanceLogging	false	false
FE.ShowOnboardingDialog	false	false
ForceMetadataWritable	false	false
ForceShowTrialUserDialog	false	false
GF.DisableAcceleratedDisplay	false	false
GF.DisableAcceleratedRenderer	false	false
GF.EnableMultipleGPUs	true	true
GF.EnableNVIDIAOpenCL	false	false
GF.ForceSync	false	false
GF.HostPoolFactor	10	10
GF.LazyHostCachePurge	true	true
GF.ProfileKernels	false	false
GF.RedGPUDebayer	true	true
GF.SupportCPUDevices	false	false
Graphics.UseStockStage	false	false
HandlerProject.Hide.RecurseIntoBins	false	false
HandlerProject.Hide.RecurseIntoSequences	false	false
HandlerTimeline.TrackHeightSnappingStrength	4	4
HapticFeedBack2	true	true
HighlightPNGImageDrawing	false	false
INTEL.ImporterMPEG.UseCustomPixelFormats	false	false
INTEL.ImporterMPEG.UseDiskAlignedPPix	true	true
IR.disableAVX	false	false
IR.disableAVX2	false	false
IgnoreDirtyState	false	false
ImportMPEG.SWSingleThread	false	false
ImporterDebugStrings	false	false
ImporterMPEG.EnableVFR	true	true
ImporterMPEG.force_MSDK_sw	false	false
ImporterMPEG.hw_min_repo_dist	61	61
ImporterMXF.DecodeQueueCPUWeight	6	6
ImporterMXF.FailSafeTimeoutInSeconds	12	12
ImporterMXF.ReadBlockSizeinKB	1024	1024
ImporterMXFEnable	true	true
ImporterQT.AnimationNativeDecoderEnabled	true	true
ImporterQuickTime.DecodeQueueThreads	0	0
ImporterRED_EnableRRX	true	true
ImporterWave.AlternateBuffersize	false	false
ImporterWave.DisableDVAAudioFile	false	false
ImporterWave.DisableLegacyWaveParser	false	false
IntelEncoder.UseHwAccEncoding	true	true
IntelEncoder.memType	2	2
LinkLocate.Auto	true	true
LogTimeInTicks	true	true
MC.AudioRenderer.ComplexityBeforeRender	200	200
MC.BE.AddDocIDOnImport	true	true
MF.MemoryControlLoop.Config.EnableCacheGrowthPolicy	true	true
MF.MemoryControlLoop.Config.EnableCacheLimitPolicy	true	true
MF.MemoryControlLoop.Config.EnableFreeMemoryPolicy	true	true
MF.MemoryControlLoop.Config.EnableMemoryLimitPolicy	true	true
MF.MemoryControlLoop.Config.ProjectionDistance	10	10
MF.MemoryControlLoopActive	true	true
ML.AudioFilterHost.ShowHiddenFilters	false	false
ML.AudioSupport.ShowAudioDropoutWarnings	false	false
ML.DeprecateTransitions	true	true
ML.EnableDiskCache	false	false
ML.LoadTestingPluginsAtStartup	false	false
ML.MaxPlaybackSpeed	32	32
ML.SimulateGrowingFiles	false	false
MPEGAACAudioRandomAccess	false	false
MPEGAllAudioRandomAccess	true	true
MPEGDisableMainConceptIndexing	false	false
MPEGDisableMultipleOpens	false	false
MZ.DisableMetadataDatabase	false	false
MZ.MetadataDatabaseIndexType	3	3
MZ.MetadataDatabaseSQLInterval	50000	50000
MZ.PreferMultichannelMasterTrack	false	false
MZ.SearchBinUpdateTimeout	5	5
MaxLogSize	0	0
MediaCache.EnableSubFolderSplitting	true	true
MinimumDelayBetweenFlushesInSeconds	1	1
Monitor.PlaybackQualityIsHigh	2	2
Monitor.ScrubbingQualityIsHigh	2	2
Monitor.StoppedQualityIsHigh	4	4
MonitorMixerRenderQuality	2	2
NumberOfInstancesBeforeContention	5	5
OverrideSpeculativePrefetchDistance	0	0
PasteAttributes.ShowESPEffects	false	false
Player.EnablePerfomanceStatics	false	false
PlayerMain.MaxOutstandingPendingAheadOfPlayback	16	16
PlayerMain.MaxQueuedFrames	300	300
PostProcessBehance.MbitUploadSpeed	1	1
PostProcessStock.MbitUploadSpeed	1	1
ProResDirectDecompressor.disableAVX2	false	false
ProjectViewSingleIcon	false	false
QE.EnableQEDOM	false	false
QE.MeasureSmartBinPerformance	false	false
QE.SkipOnboarding	false	false
QT.EnableAudioAggregation	true	true
QT.EnableDirectProResDecode	1	1
QT.ForceReferenceMoviesToImporterQuickTime	false	false
QT.PreflightExternalReferences	true	true
REDRocketCompletelyDisabled	false	false
REDRocketMaximumNumberOfCardsToUse	0	0
Rush.DisableWorkspaces	true	true
RushEnableRichToolTip	false	false
SM.ReduceDB	true	true
ScratchDiskHistoryLength	10	10
ScriptLayerPPro.EnableNewWorld	false	false
ShowExperimentalEffectParameters	false	false
SupportLightUI.PPro	false	false
SuppressCrashHandlerDialog	false	false
SuppressInternalClipboard	false	false
SuppressPeakFileGeneration	false	false
TabDragThresholdDistance	5	5
TabUndockThresholdDown	20	20
TabUndockThresholdLeft	0	0
TabUndockThresholdRight	0	0
TabUndockThresholdUp	10	10
TimecodeView.EnableProjectPropertyOverrides	false	false
TimecodeView.Horizontal.Compact.ExtraLabelWidth	2	2
TimecodeView.Horizontal.ControlsTopOffset	10	10
TimecodeView.Horizontal.FirstTimecodeLeftMargin	10	10
TimecodeView.Horizontal.LabelHeight	12	12
TimecodeView.Horizontal.MarginBetweenTCAndScrollBar	0	0
TimecodeView.Horizontal.MaxTimecodeWidth	2000	2000
TimecodeView.Horizontal.TimecodeLeftRightMarginFractionOfWidth	0.15000000596	0.15000000596
TimecodeView.Horizontal.TimecodeTopMargin	2	2
TimecodeView.HorizontalLayoutAspectRatioThreshold	3	3
TimecodeView.PadLeadingZeroForFirstMinute	false	false
TimecodeView.Tabless	true	true
TimecodeView.UseDebugControlOutlines	false	false
TimecodeView.UseEntryAspectRatioAsLayoutThreshold	false	false
TimecodeView.Vertical.ControlsLeftOffset	12	12
TimecodeView.Vertical.LabelFontSize	12	12
TimecodeView.Vertical.LabelHeight	12	12
TimecodeView.Vertical.LabelTopMargin	12	12
TimecodeView.Vertical.MaxTimecodeHeight	1000	1000
TimecodeView.Vertical.RightMarginBetweenTCAndScrollBar	2	2
TimecodeView.Vertical.SeparatorHeight	1	1
TimecodeView.Vertical.TimecodeBottomMargin	5	5
TimecodeView.Vertical.TimecodeTopMargin	0	0
TraceAsync	false	false
TraceProjectItemStructure	false	false
TrackControlPointConnectorVerticalHitRange	5	5
TrackHeightScrollTimeout	0.5	0.5
TransformEffectNumSamples	17	17
TransmitVR.Enable	true	true
Use D2D Supplier	false	false
UseLegacyAudioFilters	true	true
VR.Bilinear	true	true
VR.FOVHViewScale	1	1
VR.FOVVViewScale	1	1
VR.FocalLength	0.360000014305	0.360000014305
assert.enabled	false	false
color.RGBCurvesParamH	700	700
color.RGBCurvesParamV	280	280
dvaaudiodevice.AlwaysRunning	true	true
dvaaudiodevice.EnableRealtimeBlockingAccessFromIOThread	false	false
dvaaudiodevice.EnableTestTone	false	false
dvanet.ProxyProcessor.MaxDelay	15	15
dvaui.AlwaysReloadKSVLayouts	false	false
dvaui.UseCustomKSVLayoutFolder	false	false
dvaworkspace.FrameAndPanelClipOSChildren	false	false
mz.enableUnitTests	false	false
